30 30 30 30 30 30 30 30 30 30 30 30 30 30 30 30 30 30 30 30 30 30 30 30 30 30 30 30 30 30 30 30 30 30 30 30 30 30 30 30 30 30 30 30 30 30 30 30 30 30 30 30 30 30 30 30 30 30 30 30 30 30 30 30 30 30 30 30 30 30 30 30 30 30 30 30 30 30 30 30 30 30 
30 5 27 27 27 27 27 27 27 27 27 27 27 27 27 27 27 27 27 27 27 27 27 27 27 27 27 27 27 27 27 27 27 27 27 27 27 27 27 27 27 27 27 27 27 27 27 27 27 27 27 27 27 27 27 27 27 27 27 27 27 27 27 27 27 27 27 27 27 27 27 27 27 27 27 27 27 27 27 27 6 30 
30 20 18 18 18 18 18 18 18 18 25 25 25 25 25 25 25 25 25 18 18 18 18 25 25 25 25 25 18 18 18 18 18 18 18 18 18 18 18 25 29 18 29 18 25 29 18 18 18 18 25 25 25 18 18 25 25 25 18 18 18 18 18 18 25 28 25 25 25 25 25 25 25 25 18 18 18 18 18 18 19 30 
30 12 26 26 26 26 26 26 26 26 26 26 26 26 26 36 18 18 18 28 18 18 18 18 18 18 18 18 18 18 18 18 18 18 18 18 18 18 18 18 35 26 26 26 26 26 36 29 25 29 18 25 25 25 18 18 18 18 18 18 18 25 25 25 25 25 25 35 26 26 26 26 26 26 26 26 26 26 26 26 13 30 
30 0 0 0 0 0 10 10 0 0 0 0 0 4 4 20 18 18 18 18 18 18 18 18 18 28 18 18 18 25 18 18 18 18 18 18 18 14 15 29 19 11 11 11 11 11 12 26 26 29 29 18 14 15 18 18 18 18 18 18 18 18 18 18 18 18 18 19 4 4 0 0 0 0 0 0 0 0 0 0 0 30
30 7 7 7 7 7 3 3 7 7 7 7 7 1 2 20 25 18 18 18 18 18 14 15 25 18 18 18 18 18 18 18 18 18 18 18 18 21 22 18 19 11 11 11 11 11 11 11 11 20 29 18 21 22 25 18 18 18 18 28 18 18 18 18 25 25 25 19 1 2 7 7 7 7 7 7 7 7 7 7 7 30
30 5 27 27 27 27 27 27 27 27 27 27 6 1 2 20 25 25 25 18 18 18 21 22 18 18 18 18 25 25 25 18 18 18 18 18 18 18 29 25 19 11 11 11 11 11 11 11 11 20 18 18 18 25 18 18 25 18 18 18 18 25 25 25 25 25 18 19 1 2 5 27 27 27 27 27 27 27 27 27 6 30 
30 20 18 18 18 18 18 18 18 18 18 18 19 1 2 12 26 26 26 26 26 26 26 26 26 26 26 26 26 26 26 36 18 25 18 18 18 18 25 18 19 11 11 11 11 11 11 11 11 20 14 15 18 18 18 18 18 18 18 25 25 25 35 26 26 26 26 13 1 2 20 18 18 18 18 18 18 18 18 18 19 30 
30 20 18 18 18 18 18 28 18 18 18 18 19 1 2 0 0 0 0 0 0 0 0 0 0 0 0 0 0 4 4 20 18 18 18 18 18 18 29 18 19 11 11 11 11 11 11 11 11 20 21 22 18 18 25 18 18 18 18 18 25 18 19 4 4 0 0 0 1 2 20 18 18 18 18 18 18 18 18 18 19 30 
30 20 18 28 18 18 18 18 18 18 18 18 19 4 4 7 7 7 7 7 7 7 7 7 7 7 7 7 7 1 2 20 25 18 18 18 18 18 25 18 42 27 6 11 11 11 11 11 5 43 18 18 25 18 18 18 18 18 18 18 18 18 19 1 2 7 7 7 4 4 20 18 18 18 18 18 14 15 18 18 19 30 
30 20 18 18 18 18 18 18 18 18 18 18 42 27 27 27 27 27 27 27 27 27 27 27 27 27 27 27 6 1 2 20 25 18 18 18 18 18 18 18 14 15 42 27 27 27 27 27 43 18 29 18 18 18 18 18 18 18 18 18 18 18 19 1 2 5 27 27 27 27 43 18 18 18 18 18 21 22 18 18 19 30 
30 20 18 18 18 18 18 18 18 18 18 18 18 18 18 18 18 25 25 25 18 18 18 18 18 18 18 18 19 1 2 20 18 25 18 18 18 18 18 18 21 22 25 29 18 18 14 15 18 29 29 18 18 18 18 18 18 18 28 25 18 25 19 1 2 20 18 18 18 18 18 31 32 25 18 25 18 18 18 18 19 30 
30 20 18 18 18 18 18 18 28 18 18 18 18 18 28 18 18 18 18 18 18 18 18 18 18 18 18 18 19 1 2 20 25 18 18 25 25 18 18 18 18 18 18 29 29 25 21 22 18 18 18 18 18 28 18 18 18 18 25 25 18 25 19 8 8 20 18 18 29 25 18 38 39 25 25 25 18 18 28 18 19 30 
30 20 18 18 18 18 18 18 18 18 18 18 18 18 18 18 18 18 18 18 18 18 18 18 18 18 18 18 19 1 2 20 18 18 25 25 18 18 18 18 18 18 18 18 18 25 18 25 18 18 25 18 18 18 18 18 18 18 25 18 18 25 19 8 8 20 18 18 18 18 18 18 18 25 18 18 18 18 18 18 19 30 
30 20 18 18 18 25 18 18 18 28 18 18 25 25 18 25 25 25 25 18 18 25 18 18 25 25 18 18 19 1 2 20 18 18 14 15 18 25 25 25 25 18 18 18 18 25 25 25 18 25 25 18 18 18 18 18 18 18 18 18 18 18 19 1 2 20 18 16 17 18 18 18 18 25 25 18 18 18 18 18 19 30 
30 12 36 28 18 18 18 18 18 25 18 25 18 25 18 18 25 18 18 18 28 18 18 25 25 18 18 25 19 1 2 20 18 18 21 22 25 25 25 25 25 18 18 18 18 18 18 25 25 18 18 18 18 18 18 35 26 26 26 26 26 26 13 1 2 20 18 23 24 18 18 29 18 18 25 18 18 18 18 35 13 30 
30 30 12 36 18 28 18 18 18 18 18 18 25 18 25 18 25 18 28 35 26 26 26 36 25 18 18 18 19 1 2 20 18 18 18 18 18 18 18 25 25 18 18 18 18 18 18 18 25 25 18 18 18 18 18 19 4 4 0 0 0 0 0 1 2 20 18 33 34 18 18 18 18 18 25 18 18 18 35 13 30 30 
30 30 30 12 26 36 18 18 18 18 18 25 18 18 18 18 18 18 35 13 30 30 30 12 36 18 25 18 19 1 2 20 18 18 18 18 18 18 18 18 18 25 25 28 18 18 18 18 18 18 18 18 25 18 18 19 1 2 7 7 7 7 7 4 4 20 18 40 41 18 25 25 25 25 25 18 18 18 19 30 30 30 
30 30 30 30 30 12 36 18 18 18 18 18 18 18 18 18 18 35 13 30 30 30 30 30 12 26 36 18 19 1 2 20 18 18 29 18 18 18 18 18 18 18 18 18 25 25 18 18 18 18 18 18 25 18 18 19 1 2 5 27 27 27 27 27 27 43 18 18 18 18 25 18 18 25 25 18 18 35 13 30 30 30 
30 30 30 30 30 30 12 36 18 29 18 25 18 18 18 18 18 19 30 30 30 30 30 30 30 30 20 18 19 1 2 20 18 18 33 34 18 28 18 25 18 18 18 25 18 18 18 18 18 18 18 25 28 18 18 19 1 2 20 18 18 18 18 18 18 18 18 18 18 18 18 18 25 18 18 18 18 19 30 30 30 30 
30 30 30 30 30 30 30 12 36 18 18 18 29 18 18 18 18 19 30 30 30 30 30 30 30 5 43 25 19 1 2 20 25 25 40 41 25 25 14 15 18 18 18 25 25 28 18 18 18 18 18 25 25 18 18 19 1 2 20 18 18 18 16 17 18 29 31 32 18 18 18 18 25 18 18 18 18 19 30 30 30 30 
30 30 30 30 30 30 30 30 12 26 26 26 36 18 18 18 18 19 30 30 30 30 30 30 5 43 29 25 19 1 2 12 26 26 26 26 26 36 21 22 18 33 34 18 25 25 18 18 18 18 16 17 25 18 18 19 1 2 20 18 18 18 23 24 18 18 38 39 18 18 18 18 25 18 18 18 18 19 30 30 30 30 
30 30 30 30 30 30 30 30 11 11 11 11 12 26 26 36 18 42 6 30 30 5 27 27 43 25 18 18 19 4 0 0 0 0 0 4 4 20 18 18 18 40 41 18 18 18 25 18 25 25 23 24 18 18 18 19 1 2 20 18 18 18 18 18 18 18 18 18 18 18 18 25 18 28 18 18 35 13 30 30 30 30 
30 30 30 30 30 30 30 30 11 11 11 11 11 11 11 12 26 26 13 30 30 12 26 36 25 25 14 15 19 4 7 7 7 7 7 1 2 20 25 25 25 18 18 18 31 32 18 18 18 18 18 25 25 18 18 19 1 2 20 18 33 34 18 18 18 29 18 18 18 18 18 25 18 28 25 18 19 30 30 30 30 30 
30 30 30 30 30 30 30 30 5 27 6 11 11 11 11 11 11 11 11 11 11 11 11 12 26 36 21 22 42 27 27 27 27 27 6 1 2 20 18 16 17 25 18 18 38 39 18 18 18 33 34 25 31 32 18 19 1 2 20 18 40 41 18 18 18 18 25 18 18 18 18 25 18 25 25 18 19 30 30 30 30 30 
30 30 30 30 30 30 30 5 43 29 19 11 11 11 11 11 11 11 11 11 11 11 11 11 11 12 18 25 18 18 29 31 32 18 19 8 8 20 18 23 24 25 18 35 26 26 26 26 36 40 41 29 38 39 18 19 1 2 20 18 18 18 18 18 18 18 18 18 25 28 18 18 25 25 18 35 13 30 30 30 30 30 
30 30 30 30 30 30 30 20 18 18 42 27 6 11 11 11 11 11 11 11 11 11 11 11 11 11 12 26 36 25 25 38 39 18 19 8 8 12 26 26 26 26 26 13 4 4 4 4 12 26 26 26 26 26 26 13 1 2 20 18 18 25 18 25 18 18 18 18 28 28 18 18 35 26 26 13 30 30 30 30 30 30
30 30 30 30 30 30 30 20 18 25 18 25 42 27 27 27 27 27 27 27 27 27 6 11 11 11 11 11 12 25 25 18 18 29 19 1 2 0 0 0 0 0 0 0 4 4 4 4 0 0 0 0 0 0 0 0 1 2 20 18 18 18 25 25 18 18 18 18 25 25 18 35 13 30 30 30 30 30 30 30 30 30
30 30 30 30 30 30 30 20 18 29 18 18 18 18 18 18 18 18 18 18 25 18 42 6 11 11 11 11 11 12 26 36 28 18 19 4 4 7 7 7 7 7 7 7 4 4 4 4 7 7 7 7 7 7 7 7 4 4 20 18 18 18 18 18 28 28 18 25 25 35 26 13 30 30 30 30 30 30 30 30 30 30
30 30 30 30 30 30 30 20 18 18 18 18 18 18 28 18 18 18 18 25 25 18 29 42 27 6 11 11 11 11 11 12 36 25 42 27 27 27 27 27 27 27 27 6 4 4 4 4 5 27 27 27 27 27 27 27 27 27 43 18 18 18 18 18 18 35 26 26 26 13 30 30 30 30 30 30 30 30 30 30 30 30
30 30 30 30 30 30 5 43 18 18 18 18 25 18 18 25 18 18 18 25 35 26 26 26 26 13 11 11 11 11 11 11 20 25 25 25 25 18 18 18 18 18 18 42 6 1 2 5 43 18 18 18 18 18 18 18 18 18 18 18 18 18 35 26 26 13 30 30 30 30 30 30 30 30 30 30 30 30 30 30 30 30
30 30 30 30 5 27 43 18 18 18 18 18 18 18 18 25 18 28 18 18 19 11 11 11 11 11 11 11 11 11 11 11 12 36 18 18 18 18 18 18 18 18 29 18 19 1 2 20 18 18 18 18 18 18 18 18 18 18 18 18 18 35 13 30 30 30 30 30 30 30 30 30 30 30 30 30 30 30 30 30 30 30
30 30 30 5 43 28 18 18 18 18 25 25 25 18 18 18 25 18 18 18 19 11 11 11 11 11 11 11 11 11 11 11 11 20 18 25 18 18 29 18 18 25 18 18 19 1 2 20 18 18 18 18 18 14 15 18 18 18 18 35 26 13 30 30 30 30 30 30 30 30 30 30 30 30 30 30 30 30 30 30 30 30
30 5 27 43 18 18 25 25 25 18 18 18 28 18 18 18 25 18 18 18 19 11 11 11 11 11 11 11 11 11 11 11 11 12 36 18 18 18 25 29 25 25 25 18 19 1 2 20 18 18 18 18 25 21 22 25 18 25 35 13 30 30 30 30 5 6 30 30 30 30 30 30 30 30 30 30 30 30 30 5 6 30
30 20 18 18 18 18 18 18 18 18 18 18 25 25 25 25 18 18 18 25 42 6 11 11 11 11 11 11 11 11 11 11 11 11 20 18 18 25 18 18 18 18 18 18 19 1 2 20 18 18 18 18 25 18 25 18 25 25 19 30 30 30 30 30 20 42 6 30 30 30 30 30 30 30 30 5 27 27 27 43 19 30
30 20 18 18 18 18 18 18 18 18 18 18 18 18 18 18 18 18 18 18 18 19 11 11 11 11 11 11 11 11 11 11 11 11 12 36 18 18 18 18 18 18 18 29 19 1 2 20 18 18 25 25 25 25 25 18 18 18 19 30 30 30 30 5 43 18 18 6 30 30 30 30 30 30 5 43 25 18 18 28 19 30
30 20 18 14 15 18 18 18 18 18 18 25 18 18 18 18 18 18 18 18 18 19 11 11 11 11 11 11 11 11 11 11 11 11 11 20 18 35 26 26 26 26 26 26 13 1 2 20 18 18 18 18 18 25 18 28 18 18 42 27 27 27 27 43 18 18 18 19 30 30 30 30 30 30 20 25 25 25 18 18 19 30
30 20 18 21 22 14 15 18 18 18 18 25 25 18 25 25 18 28 18 18 18 42 27 6 11 11 11 11 11 11 11 11 11 11 11 12 36 19 4 4 0 0 0 0 0 1 2 20 18 18 18 18 18 25 18 18 18 18 18 18 18 18 18 18 28 18 18 42 27 27 27 27 27 27 43 25 35 26 26 36 19 30
30 20 29 18 18 21 22 14 15 18 18 18 18 18 18 18 25 25 18 18 18 18 18 42 6 11 11 11 11 11 11 11 11 11 11 11 20 19 1 2 7 7 7 7 7 4 4 20 18 18 18 18 18 18 18 18 35 26 26 26 36 18 25 25 25 18 25 25 18 25 18 18 18 18 18 18 19 30 30 12 13 30
30 20 18 18 29 18 18 21 22 18 18 18 18 25 25 25 25 18 25 25 25 25 25 18 42 6 11 11 11 11 11 11 11 11 11 11 20 19 1 2 5 27 27 27 27 27 27 43 18 18 18 28 18 18 18 18 19 30 30 30 12 36 25 25 35 26 26 26 36 18 25 25 18 18 28 18 19 30 30 30 30 30
30 20 14 15 14 15 14 15 14 15 18 18 18 18 18 18 18 18 18 18 18 18 18 18 18 42 6 11 11 11 11 11 11 11 11 11 20 19 1 2 20 18 18 18 18 29 18 18 18 18 18 18 18 18 18 35 13 30 30 30 30 12 36 25 19 30 30 30 12 36 18 35 26 36 18 25 19 30 30 30 30 30
30 20 21 22 21 22 21 22 21 22 18 18 18 28 18 18 18 18 18 18 18 18 18 18 18 18 42 27 27 27 27 27 27 27 27 27 43 19 1 2 20 18 31 32 18 18 18 25 25 18 18 18 18 18 35 13 30 30 30 30 30 30 20 18 19 30 30 30 30 20 18 19 30 20 18 25 19 30 30 30 30 30
30 20 18 14 15 14 15 14 15 14 15 18 18 18 35 26 26 26 26 26 26 26 26 26 26 26 26 26 26 26 26 26 26 26 26 26 26 13 1 2 20 18 38 39 25 18 25 25 25 25 25 25 25 35 13 30 30 30 30 30 30 30 20 25 42 6 30 30 30 12 26 13 30 12 26 36 42 6 30 30 30 30
30 20 25 21 22 21 22 21 22 21 22 18 18 18 19 4 4 0 0 0 0 0 0 0 0 0 0 0 10 10 0 0 0 0 0 0 0 0 1 2 20 18 18 25 18 18 18 25 25 25 18 18 35 13 30 30 30 30 30 30 30 5 43 25 25 19 30 30 30 30 30 30 30 30 30 12 36 42 6 30 30 30
30 20 18 18 14 15 14 15 14 15 14 15 18 18 19 1 2 7 7 7 7 7 7 7 7 7 7 7 3 3 7 7 7 7 7 7 7 7 4 4 20 18 18 25 29 25 18 18 18 18 18 35 13 30 30 30 30 30 30 30 5 43 18 28 18 19 30 30 30 30 30 30 30 30 30 30 12 26 13 30 30 30 
30 20 29 18 21 22 21 22 21 22 21 22 18 18 19 1 2 5 27 27 27 27 27 27 27 27 27 27 27 27 27 27 27 27 27 27 27 27 27 27 43 18 18 18 18 25 25 25 18 18 18 19 30 30 30 30 30 30 30 5 43 18 18 18 18 42 27 27 27 27 27 6 30 30 30 30 30 30 30 30 30 30 
30 12 26 26 26 26 26 26 26 26 26 26 26 26 13 1 2 12 26 26 26 26 26 26 26 26 26 26 26 26 26 26 26 26 26 26 26 26 26 26 26 26 26 26 26 26 26 26 26 26 26 13 30 30 30 30 30 30 30 12 26 26 26 26 26 26 26 26 26 26 26 13 30 30 30 30 30 30 30 30 30 30 
30 30 30 30 30 30 30 30 30 30 30 30 30 30 30 30 30 30 30 30 30 30 30 30 30 30 30 30 30 30 30 30 30 30 30 30 30 30 30 30 30 30 30 30 30 30 30 30 30 30 30 30 30 30 30 30 30 30 30 30 30 30 30 30 30 30 30 30 30 30 30 30 30 30 30 30 30 30 30 30 30 30