11 12 36 21 22 29 19 30 4 1 2 4 30 20 29 25 18 25 19 30 
11 11 20 29 25 18 19 30 4 1 2 4 30 20 25 18 18 29 19 30 
11 11 12 36 18 18 19 30 4 1 2 4 30 20 18 31 32 18 19 30 
11 11 11 20 18 18 19 30 4 1 2 4 30 20 18 38 39 18 19 30 
11 11 11 12 36 29 19 30 4 1 2 4 30 20 18 18 25 29 19 30 
11 11 11 11 20 25 19 30 4 1 2 4 30 20 18 29 18 25 19 30 
11 11 11 11 12 36 19 30 4 1 2 4 30 20 18 18 18 29 19 30 
11 11 11 11 11 20 19 30 4 1 2 4 30 20 14 15 18 18 19 30 
11 11 11 11 11 20 19 30 4 1 2 4 30 20 21 22 14 15 19 30 
11 11 11 11 11 20 19 30 4 1 2 4 30 20 28 18 21 22 19 30 
11 11 11 11 11 20 19 30 4 1 2 4 30 20 14 15 25 18 19 30 
11 11 11 11 11 20 19 30 4 1 2 4 30 20 21 22 18 18 19 30 
11 11 11 11 11 20 19 30 4 1 2 4 30 20 18 25 14 15 19 30 
11 11 11 11 11 20 19 30 4 1 2 4 30 20 14 15 21 22 19 30 
11 11 11 11 11 20 19 30 4 1 2 4 30 20 21 22 25 18 19 30 
11 11 11 11 11 20 19 30 4 1 2 4 30 20 25 18 29 18 19 30 
11 11 11 11 11 20 19 30 4 1 2 4 30 20 14 15 18 18 19 30 
11 11 11 11 5 43 19 30 4 1 2 4 30 20 21 22 18 18 19 30 
11 11 11 5 43 25 19 30 4 1 2 4 30 20 18 18 18 29 19 30 
11 11 11 20 18 25 19 30 4 1 2 4 30 20 28 18 18 25 19 30 
11 11 5 43 18 18 19 30 4 1 2 4 30 20 18 29 25 25 19 30 
11 5 43 29 18 18 19 30 4 1 2 4 30 20 18 18 18 18 19 30 
11 20 18 18 25 18 19 30 4 1 2 4 30 20 18 29 18 29 19 30 
30 20 18 18 18 29 19 30 4 1 2 4 30 20 18 25 18 18 19 30 
30 20 18 18 18 25 19 30 4 1 2 4 30 20 18 25 18 18 19 30 
30 20 29 18 18 18 19 30 4 1 2 4 30 20 29 18 18 29 19 30 
30 20 18 18 18 18 19 30 4 1 2 4 30 20 18 18 18 25 19 30 
30 20 18 16 17 25 19 30 4 1 2 4 30 20 18 18 28 18 19 30 
30 20 18 23 24 18 19 30 4 1 2 4 30 20 18 28 18 25 19 30 
30 20 25 18 18 18 19 30 4 1 2 4 30 20 18 25 18 25 19 30 
30 20 18 25 18 29 19 30 4 1 2 4 30 20 18 18 18 25 19 30 
30 20 18 31 32 18 19 30 4 1 2 4 30 20 18 28 18 25 19 30 
30 20 18 38 39 18 19 30 4 1 2 4 30 20 18 25 18 28 19 30 
30 20 25 18 18 25 19 30 4 1 2 4 30 20 28 25 18 18 19 30 
30 20 29 18 18 28 19 30 4 1 2 4 30 20 18 25 18 25 19 30 
30 20 18 33 34 25 19 30 4 1 2 4 30 20 28 25 28 18 19 30 
30 20 18 40 41 25 19 30 4 1 2 4 30 20 18 25 25 18 19 30 
30 20 25 25 18 18 19 30 4 1 2 4 30 20 35 26 18 18 19 30 
30 20 28 18 18 25 19 30 4 1 2 4 30 20 19 30 20 25 19 30 
30 20 18 31 32 25 19 30 4 1 2 4 30 20 19 30 12 36 19 30 
30 20 25 38 39 25 19 30 4 1 2 4 30 20 19 30 30 20 19 30 
30 20 18 25 18 25 19 30 4 1 2 4 30 20 19 30 30 20 19 30 
30 20 29 25 18 25 19 30 4 1 2 4 30 20 19 30 5 43 19 30 
30 20 25 14 15 25 19 30 4 1 2 4 30 20 19 30 12 36 19 30 
30 20 18 21 22 25 19 30 4 1 2 4 30 20 19 30 30 20 19 30 
30 20 14 15 18 18 19 30 4 1 2 4 30 20 19 30 30 20 19 30 
30 20 21 22 18 18 19 30 4 1 2 4 30 20 42 6 30 20 19 30 
30 20 29 14 15 25 19 30 4 1 2 4 30 20 18 19 30 20 19 30 
30 20 25 21 22 29 19 30 4 1 2 4 30 20 18 42 27 43 19 30 
30 20 14 15 18 18 19 30 4 1 2 4 30 20 18 28 18 25 19 30 
30 20 21 22 25 18 19 30 4 1 2 4 30 20 18 18 18 28 19 30 
30 20 25 14 15 18 19 30 4 1 2 4 30 20 28 18 18 18 19 30 
30 20 25 21 22 25 19 30 4 1 2 4 30 20 25 18 18 28 19 30 
30 20 14 15 18 25 19 30 4 1 2 4 30 20 18 18 18 25 19 30 
30 20 21 22 18 29 19 30 4 1 2 4 30 20 29 25 18 25 19 30 
30 20 18 14 15 18 19 30 4 1 2 4 30 20 18 31 32 25 19 30 
30 20 25 21 22 18 19 30 4 1 2 4 30 20 25 38 39 29 19 30 
30 20 29 18 18 18 19 30 4 1 2 4 30 20 18 18 25 25 19 30 
30 20 25 18 29 18 19 30 4 1 2 4 30 20 18 33 34 18 19 30 
30 20 29 18 18 25 19 30 4 1 2 4 30 20 18 40 41 18 19 30 
30 20 18 18 18 29 19 30 4 1 2 4 30 20 29 18 25 18 19 30 
30 20 18 28 18 25 19 30 4 1 2 4 30 20 18 31 32 18 19 30 
30 20 18 18 18 18 19 30 4 1 2 4 30 20 18 38 39 18 19 30 
30 20 18 18 18 28 19 30 4 1 2 4 30 20 18 18 18 25 19 30 
30 20 28 18 18 18 19 30 4 1 2 4 30 20 18 18 18 29 19 30 
30 20 25 18 18 25 19 30 4 1 2 4 30 20 14 15 18 18 19 30 
30 20 35 26 36 18 19 30 4 1 2 4 30 20 21 22 18 25 19 30 
30 20 19 30 12 36 19 30 4 1 2 4 30 20 18 25 18 29 19 30 
30 20 19 30 30 20 19 30 4 1 2 4 30 20 14 15 18 18 19 30 
30 20 19 30 30 20 19 30 4 1 2 4 30 20 21 22 18 25 19 30 
30 20 42 6 30 20 19 30 4 1 2 4 30 20 18 25 18 29 19 30 
30 20 18 19 30 20 19 30 4 1 2 4 30 20 14 15 18 25 19 30 
30 20 35 13 30 20 19 30 4 1 2 4 30 20 21 22 18 18 19 30 
30 20 19 30 30 20 19 30 4 1 2 4 30 20 18 18 18 29 19 30 
30 20 19 30 30 20 19 30 4 1 2 4 30 20 14 15 18 18 19 30 
30 20 19 30 5 43 19 30 4 1 2 4 30 20 21 22 25 18 19 30 
30 20 19 30 20 18 19 30 4 1 2 4 30 20 18 18 18 28 19 30 
30 20 19 30 12 36 19 30 4 1 2 4 30 20 18 16 17 25 19 30 
30 20 19 30 30 20 19 30 4 1 2 4 30 20 18 23 24 18 19 30 
30 20 19 30 30 20 19 30 4 1 2 4 30 20 25 18 18 25 19 30 
30 20 42 27 27 43 19 30 4 1 2 4 30 20 18 18 18 18 19 30 
30 20 25 18 18 25 19 30 4 1 2 4 30 20 28 18 25 18 19 30 
30 20 18 28 25 18 19 30 4 1 2 4 30 20 18 18 18 18 19 30 
30 20 25 18 28 18 19 30 4 1 2 4 30 20 18 29 18 25 19 30 
30 20 18 18 18 18 19 30 4 1 2 4 30 20 18 18 18 25 19 30 
30 20 28 18 25 18 19 30 4 1 2 4 30 20 18 25 18 28 19 30 
30 20 25 18 28 18 19 30 4 1 2 4 30 20 25 18 25 18 19 30 
30 20 25 18 18 18 19 30 4 1 2 4 30 20 29 25 18 18 19 30 
30 20 28 18 18 28 19 30 4 1 2 4 30 20 35 26 26 36 19 30 
30 20 18 29 18 18 19 30 4 1 2 4 30 20 19 11 11 20 19 30 
30 20 25 18 18 18 19 30 4 1 2 4 30 20 19 11 11 20 19 30 
30 20 18 18 28 18 19 30 4 1 2 4 30 20 42 6 11 20 19 30 
30 20 18 18 18 18 19 30 4 1 2 4 30 20 35 13 11 20 19 30 
30 20 29 18 18 25 19 30 4 1 2 4 30 20 19 11 11 20 19 30 
30 20 18 18 29 18 19 30 4 1 2 4 30 20 19 11 11 20 19 30 
30 20 25 18 18 18 19 30 4 1 2 4 30 20 19 11 5 43 19 30 
30 20 18 16 17 18 19 30 4 1 2 4 30 20 42 27 43 25 19 30 
30 20 18 23 24 18 19 30 4 1 2 4 30 20 18 29 18 18 19 30 
30 20 29 18 18 25 19 30 4 1 2 4 30 20 25 18 18 25 19 30 
30 20 18 14 15 18 19 30 4 1 2 4 30 20 18 18 18 29 19 30 
11 12 36 21 22 29 19 30 4 1 2 4 30 20 29 25 18 25 19 30 
11 11 20 29 25 18 19 30 4 1 2 4 30 20 25 18 18 29 19 30 
11 11 12 36 18 18 19 30 4 1 2 4 30 20 18 31 32 18 19 30 
11 11 11 20 18 18 19 30 4 1 2 4 30 20 18 38 39 18 19 30 
11 11 11 12 36 29 19 30 4 1 2 4 30 20 18 18 25 29 19 30 
11 11 11 11 20 25 19 30 4 1 2 4 30 20 18 29 18 25 19 30 
11 11 11 11 12 36 19 30 4 1 2 4 30 20 18 18 18 29 19 30 
11 11 11 11 11 20 19 30 4 1 2 4 30 20 14 15 18 18 19 30 
11 11 11 11 11 20 19 30 4 1 2 4 30 20 21 22 14 15 19 30 
11 11 11 11 11 20 19 30 4 1 2 4 30 20 28 18 21 22 19 30 
11 11 11 11 11 20 19 30 4 1 2 4 30 20 14 15 25 18 19 30 
11 11 11 11 11 20 19 30 4 1 2 4 30 20 21 22 18 18 19 30 
11 11 11 11 11 20 19 30 4 1 2 4 30 20 18 25 14 15 19 30 
11 11 11 11 11 20 19 30 4 1 2 4 30 20 14 15 21 22 19 30 
11 11 11 11 11 20 19 30 4 1 2 4 30 20 21 22 25 18 19 30 
11 11 11 11 11 20 19 30 4 1 2 4 30 20 25 18 29 18 19 30 
11 11 11 11 11 20 19 30 4 1 2 4 30 20 14 15 18 18 19 30 
11 11 11 11 5 43 19 30 4 1 2 4 30 20 21 22 18 18 19 30 
11 11 11 5 43 25 19 30 4 1 2 4 30 20 18 18 18 29 19 30 
11 11 11 20 18 25 19 30 4 1 2 4 30 20 28 18 18 25 19 30 
11 11 5 43 18 18 19 30 4 1 2 4 30 20 18 29 25 25 19 30 
11 5 43 29 18 18 19 30 4 1 2 4 30 20 18 18 18 18 19 30 
11 20 18 18 25 18 19 30 4 1 2 4 30 20 18 29 18 29 19 30 
30 20 18 18 18 29 19 30 4 1 2 4 30 20 18 25 18 18 19 30 
30 20 18 18 18 25 19 30 4 1 2 4 30 20 18 25 18 18 19 30 
30 20 29 18 18 18 19 30 4 1 2 4 30 20 29 18 18 29 19 30 
30 20 18 18 18 18 19 30 4 1 2 4 30 20 18 18 18 25 19 30 
30 20 18 16 17 25 19 30 4 1 2 4 30 20 18 18 28 18 19 30 
30 20 18 23 24 18 19 30 4 1 2 4 30 20 18 28 18 25 19 30 
30 20 25 18 18 18 19 30 4 1 2 4 30 20 18 25 18 25 19 30 
30 20 18 25 18 29 19 30 4 1 2 4 30 20 18 18 18 25 19 30 
30 20 18 31 32 18 19 30 4 1 2 4 30 20 18 28 18 25 19 30 
30 20 18 38 39 18 19 30 4 1 2 4 30 20 18 25 18 28 19 30 
30 20 25 18 18 25 19 30 4 1 2 4 30 20 28 25 18 18 19 30 
30 20 29 18 18 28 19 30 4 1 2 4 30 20 18 25 18 25 19 30 
30 20 18 33 34 25 19 30 4 1 2 4 30 20 28 25 28 18 19 30 
30 20 18 40 41 25 19 30 4 1 2 4 30 20 18 25 25 18 19 30 
30 20 25 25 18 18 19 30 4 1 2 4 30 20 35 26 18 18 19 30 
30 20 28 18 18 25 19 30 4 1 2 4 30 20 19 30 20 25 19 30 
30 20 18 31 32 25 19 30 4 1 2 4 30 20 19 30 12 36 19 30 
30 20 25 38 39 25 19 30 4 1 2 4 30 20 19 30 30 20 19 30 
30 20 18 25 18 25 19 30 4 1 2 4 30 20 19 30 30 20 19 30 
30 20 29 25 18 25 19 30 4 1 2 4 30 20 19 30 5 43 19 30 
30 20 25 14 15 25 19 30 4 1 2 4 30 20 19 30 12 36 19 30 
30 20 18 21 22 25 19 30 4 1 2 4 30 20 19 30 30 20 19 30 
30 20 14 15 18 18 19 30 4 1 2 4 30 20 19 30 30 20 19 30 
30 20 21 22 18 18 19 30 4 1 2 4 30 20 42 6 30 20 19 30 
30 20 29 14 15 25 19 30 4 1 2 4 30 20 18 19 30 20 19 30 
30 20 25 21 22 29 19 30 4 1 2 4 30 20 18 42 27 43 19 30 
30 20 14 15 18 18 19 30 4 1 2 4 30 20 18 28 18 25 19 30 
30 20 21 22 25 18 19 30 4 1 2 4 30 20 18 18 18 28 19 30 
30 20 25 14 15 18 19 30 4 1 2 4 30 20 28 18 18 18 19 30 
30 20 25 21 22 25 19 30 4 1 2 4 30 20 25 18 18 28 19 30 
30 20 14 15 18 25 19 30 4 1 2 4 30 20 18 18 18 25 19 30 
30 20 21 22 18 29 19 30 4 1 2 4 30 20 29 25 18 25 19 30 
30 20 18 14 15 18 19 30 4 1 2 4 30 20 18 31 32 25 19 30 
30 20 25 21 22 18 19 30 4 1 2 4 30 20 25 38 39 29 19 30 
30 20 29 18 18 18 19 30 4 1 2 4 30 20 18 18 25 25 19 30 
30 20 25 18 29 18 19 30 4 1 2 4 30 20 18 33 34 18 19 30 
30 20 29 18 18 25 19 30 4 1 2 4 30 20 18 40 41 18 19 30 
30 20 18 18 18 29 19 30 4 1 2 4 30 20 29 18 25 18 19 30 
30 20 18 28 18 25 19 30 4 1 2 4 30 20 18 31 32 18 19 30 
30 20 18 18 18 18 19 30 4 1 2 4 30 20 18 38 39 18 19 30 
30 20 18 18 18 28 19 30 4 1 2 4 30 20 18 18 18 25 19 30 
30 20 28 18 18 18 19 30 4 1 2 4 30 20 18 18 18 29 19 30 
30 20 25 18 18 25 19 30 4 1 2 4 30 20 14 15 18 18 19 30 
30 20 35 26 36 18 19 30 4 1 2 4 30 20 21 22 18 25 19 30 
30 20 19 30 12 36 19 30 4 1 2 4 30 20 18 25 18 29 19 30 
30 20 19 30 30 20 19 30 4 1 2 4 30 20 14 15 18 18 19 30 
30 20 19 30 30 20 19 30 4 1 2 4 30 20 21 22 18 25 19 30 
30 20 42 6 30 20 19 30 4 1 2 4 30 20 18 25 18 29 19 30 
30 20 18 19 30 20 19 30 4 1 2 4 30 20 14 15 18 25 19 30 
30 20 35 13 30 20 19 30 4 1 2 4 30 20 21 22 18 18 19 30 
30 20 19 30 30 20 19 30 4 1 2 4 30 20 18 18 18 29 19 30 
30 20 19 30 30 20 19 30 4 1 2 4 30 20 14 15 18 18 19 30 
30 20 19 30 5 43 19 30 4 1 2 4 30 20 21 22 25 18 19 30 
30 20 19 30 20 18 19 30 4 1 2 4 30 20 18 18 18 28 19 30 
30 20 19 30 12 36 19 30 4 1 2 4 30 20 18 16 17 25 19 30 
30 20 19 30 30 20 19 30 4 1 2 4 30 20 18 23 24 18 19 30 
30 20 19 30 30 20 19 30 4 1 2 4 30 20 25 18 18 25 19 30 
30 20 42 27 27 43 19 30 4 1 2 4 30 20 18 18 18 18 19 30 
30 20 25 18 18 25 19 30 4 1 2 4 30 20 28 18 25 18 19 30 
30 20 18 28 25 18 19 30 4 1 2 4 30 20 18 18 18 18 19 30 
30 20 25 18 28 18 19 30 4 1 2 4 30 20 18 29 18 25 19 30 
30 20 18 18 18 18 19 30 4 1 2 4 30 20 18 18 18 25 19 30 
30 20 28 18 25 18 19 30 4 1 2 4 30 20 18 25 18 28 19 30 
30 20 25 18 28 18 19 30 4 1 2 4 30 20 25 18 25 18 19 30 
30 20 25 18 18 18 19 30 4 1 2 4 30 20 29 25 18 18 19 30 
30 20 28 18 18 28 19 30 4 1 2 4 30 20 35 26 26 36 19 30 
30 20 18 29 18 18 19 30 4 1 2 4 30 20 19 11 11 20 19 30 
30 20 25 18 18 18 19 30 4 1 2 4 30 20 19 11 11 20 19 30 
30 20 18 18 28 18 19 30 4 1 2 4 30 20 42 6 11 20 19 30 
30 20 18 18 18 18 19 30 4 1 2 4 30 20 35 13 11 20 19 30 
30 20 29 18 18 25 19 30 4 1 2 4 30 20 19 11 11 20 19 30 
30 20 18 18 29 18 19 30 4 1 2 4 30 20 19 11 11 20 19 30 
30 20 25 18 18 18 19 30 4 1 2 4 30 20 19 11 5 43 19 30 
30 20 18 16 17 18 19 30 4 1 2 4 30 20 42 27 43 25 19 30 
30 20 18 23 24 18 19 30 4 1 2 4 30 20 18 29 18 18 19 30 
30 20 29 18 18 25 19 30 4 1 2 4 30 20 25 18 18 25 19 30 
30 20 18 14 15 18 19 30 4 1 2 4 30 20 18 18 18 29 19 30 
11 12 36 21 22 29 19 30 4 1 2 4 30 20 29 25 18 25 19 30
11 11 20 29 25 18 19 30 4 1 2 4 30 20 25 18 18 29 19 30
11 11 12 36 18 18 19 30 4 1 2 4 30 20 18 31 32 18 19 30
11 11 11 20 18 18 19 30 4 1 2 4 30 20 18 38 39 18 19 30
11 11 11 12 36 29 19 30 4 1 2 4 30 20 18 18 25 29 19 30
11 11 11 11 20 25 19 30 4 1 2 4 30 20 18 29 18 25 19 30
11 11 11 11 12 36 19 30 4 1 2 4 30 20 18 18 18 29 19 30
11 11 11 11 11 20 19 30 4 1 2 4 30 20 14 15 18 18 19 30
11 11 11 11 11 20 19 30 4 1 2 4 30 20 21 22 14 15 19 30
11 11 11 11 11 20 19 30 4 1 2 4 30 20 28 18 21 22 19 30
11 11 11 11 11 20 19 30 4 1 2 4 30 20 14 15 25 18 19 30
11 11 11 11 11 20 19 30 4 1 2 4 30 20 21 22 18 18 19 30
11 11 11 11 11 20 19 30 4 1 2 4 30 20 18 25 14 15 19 30
11 11 11 11 11 20 19 30 4 1 2 4 30 20 14 15 21 22 19 30
11 11 11 11 11 20 19 30 4 1 2 4 30 20 21 22 25 18 19 30
11 11 11 11 11 20 19 30 4 1 2 4 30 20 25 18 29 18 19 30
11 11 11 11 11 20 19 30 4 1 2 4 30 20 14 15 18 18 19 30
11 11 11 11 5 43 19 30 4 1 2 4 30 20 21 22 18 18 19 30
11 11 11 5 43 25 19 30 4 1 2 4 30 20 18 18 18 29 19 30
11 11 11 20 18 25 19 30 4 1 2 4 30 20 28 18 18 25 19 30
11 11 5 43 18 18 19 30 4 1 2 4 30 20 18 29 25 25 19 30
11 5 43 29 18 18 19 30 4 1 2 4 30 20 18 18 18 18 19 30
11 20 18 18 25 18 19 30 4 1 2 4 30 20 18 29 18 29 19 30
30 20 18 18 18 29 19 30 4 1 2 4 30 20 18 25 18 18 19 30
30 20 18 18 18 25 19 30 4 1 2 4 30 20 18 25 18 18 19 30
30 20 29 18 18 18 19 30 4 1 2 4 30 20 29 18 18 29 19 30
30 20 18 18 18 18 19 30 4 1 2 4 30 20 18 18 18 25 19 30
30 20 18 16 17 25 19 30 4 1 2 4 30 20 18 18 28 18 19 30
30 20 18 23 24 18 19 30 4 1 2 4 30 20 18 28 18 25 19 30
30 20 25 18 18 18 19 30 4 1 2 4 30 20 18 25 18 25 19 30
30 20 18 25 18 29 19 30 4 1 2 4 30 20 18 18 18 25 19 30
30 20 18 31 32 18 19 30 4 1 2 4 30 20 18 28 18 25 19 30
30 20 18 38 39 18 19 30 4 1 2 4 30 20 18 25 18 28 19 30
30 20 25 18 18 25 19 30 4 1 2 4 30 20 28 25 18 18 19 30
30 20 29 18 18 28 19 30 4 1 2 4 30 20 18 25 18 25 19 30
30 20 18 33 34 25 19 30 4 1 2 4 30 20 28 25 28 18 19 30
30 20 18 40 41 25 19 30 4 1 2 4 30 20 18 25 25 18 19 30
30 20 25 25 18 18 19 30 4 1 2 4 30 20 35 26 18 18 19 30
30 20 28 18 18 25 19 30 4 1 2 4 30 20 19 30 20 25 19 30
30 20 18 31 32 25 19 30 4 1 2 4 30 20 19 30 12 36 19 30
30 20 25 38 39 25 19 30 4 1 2 4 30 20 19 30 30 20 19 30
30 20 18 25 18 25 19 30 4 1 2 4 30 20 19 30 30 20 19 30
30 20 29 25 18 25 19 30 4 1 2 4 30 20 19 30 5 43 19 30
30 20 25 14 15 25 19 30 4 1 2 4 30 20 19 30 12 36 19 30
30 20 18 21 22 25 19 30 4 1 2 4 30 20 19 30 30 20 19 30
30 20 14 15 18 18 19 30 4 1 2 4 30 20 19 30 30 20 19 30
30 20 21 22 18 18 19 30 4 1 2 4 30 20 42 6 30 20 19 30
30 20 29 14 15 25 19 30 4 1 2 4 30 20 18 19 30 20 19 30
30 20 25 21 22 29 19 30 4 1 2 4 30 20 18 42 27 43 19 30
30 20 14 15 18 18 19 30 4 1 2 4 30 20 18 28 18 25 19 30
30 20 21 22 25 18 19 30 4 1 2 4 30 20 18 18 18 28 19 30
30 20 25 14 15 18 19 30 4 1 2 4 30 20 28 18 18 18 19 30
30 20 25 21 22 25 19 30 4 1 2 4 30 20 25 18 18 28 19 30
30 20 14 15 18 25 19 30 4 1 2 4 30 20 18 18 18 25 19 30
30 20 21 22 18 29 19 30 4 1 2 4 30 20 29 25 18 25 19 30
30 20 18 14 15 18 19 30 4 1 2 4 30 20 18 31 32 25 19 30
30 20 25 21 22 18 19 30 4 1 2 4 30 20 25 38 39 29 19 30
30 20 29 18 18 18 19 30 4 1 2 4 30 20 18 18 25 25 19 30
30 20 25 18 29 18 19 30 4 1 2 4 30 20 18 33 34 18 19 30
30 20 29 18 18 25 19 30 4 1 2 4 30 20 18 40 41 18 19 30
30 20 18 18 18 29 19 30 4 1 2 4 30 20 29 18 25 18 19 30
30 20 18 28 18 25 19 30 4 1 2 4 30 20 18 31 32 18 19 30
30 20 18 18 18 18 19 30 4 1 2 4 30 20 18 38 39 18 19 30
30 20 18 18 18 28 19 30 4 1 2 4 30 20 18 18 18 25 19 30
30 20 28 18 18 18 19 30 4 1 2 4 30 20 18 18 18 29 19 30
30 20 25 18 18 25 19 30 4 1 2 4 30 20 14 15 18 18 19 30
30 20 35 26 36 18 19 30 4 1 2 4 30 20 21 22 18 25 19 30
30 20 19 30 12 36 19 30 4 1 2 4 30 20 18 25 18 29 19 30
30 20 19 30 30 20 19 30 4 1 2 4 30 20 14 15 18 18 19 30
30 20 19 30 30 20 19 30 4 1 2 4 30 20 21 22 18 25 19 30
30 20 42 6 30 20 19 30 4 1 2 4 30 20 18 25 18 29 19 30
30 20 18 19 30 20 19 30 4 1 2 4 30 20 14 15 18 25 19 30
30 20 35 13 30 20 19 30 4 1 2 4 30 20 21 22 18 18 19 30
30 20 19 30 30 20 19 30 4 1 2 4 30 20 18 18 18 29 19 30
30 20 19 30 30 20 19 30 4 1 2 4 30 20 14 15 18 18 19 30
30 20 19 30 5 43 19 30 4 1 2 4 30 20 21 22 25 18 19 30
30 20 19 30 20 18 19 30 4 1 2 4 30 20 18 18 18 28 19 30
30 20 19 30 12 36 19 30 4 1 2 4 30 20 18 16 17 25 19 30
30 20 19 30 30 20 19 30 4 1 2 4 30 20 18 23 24 18 19 30
30 20 19 30 30 20 19 30 4 1 2 4 30 20 25 18 18 25 19 30
30 20 42 27 27 43 19 30 4 1 2 4 30 20 18 18 18 18 19 30
30 20 25 18 18 25 19 30 4 1 2 4 30 20 28 18 25 18 19 30
30 20 18 28 25 18 19 30 4 1 2 4 30 20 18 18 18 18 19 30
30 20 25 18 28 18 19 30 4 1 2 4 30 20 18 29 18 25 19 30
30 20 18 18 18 18 19 30 4 1 2 4 30 20 18 18 18 25 19 30
30 20 28 18 25 18 19 30 4 1 2 4 30 20 18 25 18 28 19 30
30 20 25 18 28 18 19 30 4 1 2 4 30 20 25 18 25 18 19 30
30 20 25 18 18 18 19 30 4 1 2 4 30 20 29 25 18 18 19 30
30 20 28 18 18 28 19 30 4 1 2 4 30 20 35 26 26 36 19 30
30 20 18 29 18 18 19 30 4 1 2 4 30 20 19 11 11 20 19 30
30 20 25 18 18 18 19 30 4 1 2 4 30 20 19 11 11 20 19 30
30 20 18 18 28 18 19 30 4 1 2 4 30 20 42 6 11 20 19 30
30 20 18 18 18 18 19 30 4 1 2 4 30 20 35 13 11 20 19 30
30 20 29 18 18 25 19 30 4 1 2 4 30 20 19 11 11 20 19 30
30 20 18 18 29 18 19 30 4 1 2 4 30 20 19 11 11 20 19 30
30 20 25 18 18 18 19 30 4 1 2 4 30 20 19 11 5 43 19 30
30 20 18 16 17 18 19 30 4 1 2 4 30 20 42 27 43 25 19 30
30 20 18 23 24 18 19 30 4 1 2 4 30 20 18 29 18 18 19 30
30 20 29 18 18 25 19 30 4 1 2 4 30 20 25 18 18 25 19 30
30 20 18 14 15 18 19 30 4 1 2 4 30 20 18 18 18 29 19 30
11 12 36 21 22 29 19 30 4 1 2 4 30 20 29 25 18 25 19 30
11 11 20 29 25 18 19 30 4 1 2 4 30 20 25 18 18 29 19 30
11 11 12 36 18 18 19 30 4 1 2 4 30 20 18 31 32 18 19 30
11 11 11 20 18 18 19 30 4 1 2 4 30 20 18 38 39 18 19 30
11 11 11 12 36 29 19 30 4 1 2 4 30 20 18 18 25 29 19 30
11 11 11 11 20 25 19 30 4 1 2 4 30 20 18 29 18 25 19 30
11 11 11 11 12 36 19 30 4 1 2 4 30 20 18 18 18 29 19 30
11 11 11 11 11 20 19 30 4 1 2 4 30 20 14 15 18 18 19 30
11 11 11 11 11 20 19 30 4 1 2 4 30 20 21 22 14 15 19 30
11 11 11 11 11 20 19 30 4 1 2 4 30 20 28 18 21 22 19 30
11 11 11 11 11 20 19 30 4 1 2 4 30 20 14 15 25 18 19 30
11 11 11 11 11 20 19 30 4 1 2 4 30 20 21 22 18 18 19 30
11 11 11 11 11 20 19 30 4 1 2 4 30 20 18 25 14 15 19 30
11 11 11 11 11 20 19 30 4 1 2 4 30 20 14 15 21 22 19 30
11 11 11 11 11 20 19 30 4 1 2 4 30 20 21 22 25 18 19 30
11 11 11 11 11 20 19 30 4 1 2 4 30 20 25 18 29 18 19 30
11 11 11 11 11 20 19 30 4 1 2 4 30 20 14 15 18 18 19 30
11 11 11 11 5 43 19 30 4 1 2 4 30 20 21 22 18 18 19 30
11 11 11 5 43 25 19 30 4 1 2 4 30 20 18 18 18 29 19 30
11 11 11 20 18 25 19 30 4 1 2 4 30 20 28 18 18 25 19 30
11 11 5 43 18 18 19 30 4 1 2 4 30 20 18 29 25 25 19 30
11 5 43 29 18 18 19 30 4 1 2 4 30 20 18 18 18 18 19 30
11 20 18 18 25 18 19 30 4 1 2 4 30 20 18 29 18 29 19 30
30 20 18 18 18 29 19 30 4 1 2 4 30 20 18 25 18 18 19 30
30 20 18 18 18 25 19 30 4 1 2 4 30 20 18 25 18 18 19 30
30 20 29 18 18 18 19 30 4 1 2 4 30 20 29 18 18 29 19 30
30 20 18 18 18 18 19 30 4 1 2 4 30 20 18 18 18 25 19 30
30 20 18 16 17 25 19 30 4 1 2 4 30 20 18 18 28 18 19 30
30 20 18 23 24 18 19 30 4 1 2 4 30 20 18 28 18 25 19 30
30 20 25 18 18 18 19 30 4 1 2 4 30 20 18 25 18 25 19 30
30 20 18 25 18 29 19 30 4 1 2 4 30 20 18 18 18 25 19 30
30 20 18 31 32 18 19 30 4 1 2 4 30 20 18 28 18 25 19 30
30 20 18 38 39 18 19 30 4 1 2 4 30 20 18 25 18 28 19 30
30 20 25 18 18 25 19 30 4 1 2 4 30 20 28 25 18 18 19 30
30 20 29 18 18 28 19 30 4 1 2 4 30 20 18 25 18 25 19 30
30 20 18 33 34 25 19 30 4 1 2 4 30 20 28 25 28 18 19 30
30 20 18 40 41 25 19 30 4 1 2 4 30 20 18 25 25 18 19 30
30 20 25 25 18 18 19 30 4 1 2 4 30 20 35 26 18 18 19 30
30 20 28 18 18 25 19 30 4 1 2 4 30 20 19 30 20 25 19 30
30 20 18 31 32 25 19 30 4 1 2 4 30 20 19 30 12 36 19 30
30 20 25 38 39 25 19 30 4 1 2 4 30 20 19 30 30 20 19 30
30 20 18 25 18 25 19 30 4 1 2 4 30 20 19 30 30 20 19 30
30 20 29 25 18 25 19 30 4 1 2 4 30 20 19 30 5 43 19 30
30 20 25 14 15 25 19 30 4 1 2 4 30 20 19 30 12 36 19 30
30 20 18 21 22 25 19 30 4 1 2 4 30 20 19 30 30 20 19 30
30 20 14 15 18 18 19 30 4 1 2 4 30 20 19 30 30 20 19 30
30 20 21 22 18 18 19 30 4 1 2 4 30 20 42 6 30 20 19 30
30 20 29 14 15 25 19 30 4 1 2 4 30 20 18 19 30 20 19 30
30 20 25 21 22 29 19 30 4 1 2 4 30 20 18 42 27 43 19 30
30 20 14 15 18 18 19 30 4 1 2 4 30 20 18 28 18 25 19 30
























