30 30 30 30 30 30 30 30 30 30 30 30 30 30 30 30 30 30 30 30 30 30 30 30 30 30 30 30 30 30 30 30 30 30 30 30 30 30 30 30 30 30 30 30 30 30 30 30 30 30 30 30 30 30 30 30 30 30 30 30 30 30 30 30 30 30 30 30 30 30 30 30 30 30 30 30 30 30 30 30 30 30 30 30 30 30 30 30 30 30 30 30 30 30 30 30 30 30 30 30 30 30 30 30 30 30 30 30 30 30 30 30 30 30 30 30 30 30 30 30 
30 5 27 27 27 27 27 27 27 27 27 27 27 27 27 27 27 27 27 27 27 27 27 27 27 27 27 27 27 27 27 27 27 27 27 27 27 27 27 27 27 27 27 27 27 27 27 27 27 27 27 27 27 27 27 27 27 27 6 1 2 5 6 30 30 30 30 30 30 30 30 30 30 30 30 30 30 30 30 30 30 30 30 30 30 30 30 30 30 30 30 30 30 30 30 30 30 30 30 30 30 30 30 30 30 30 30 30 30 30 30 30 30 30 30 30 30 30 30 30 
30 20 25 14 15 18 29 18 18 14 15 18 18 25 18 14 15 18 18 18 18 18 18 18 18 18 18 18 18 18 18 18 18 18 18 18 18 18 18 18 18 18 18 18 18 18 18 18 18 18 18 18 18 18 18 18 18 18 19 1 2 20 42 27 27 27 27 6 30 30 30 30 30 30 30 30 30 30 30 30 30 30 30 30 30 30 30 30 30 30 30 30 30 5 27 27 27 27 27 27 27 27 6 30 30 30 30 30 30 30 30 30 30 30 30 30 30 30 30 30 
30 20 18 21 22 18 14 15 18 21 22 18 14 15 18 21 22 18 18 18 18 18 18 18 29 18 18 18 18 18 18 18 18 18 18 18 18 25 25 18 18 18 18 18 18 18 18 18 25 18 18 18 18 18 18 28 18 18 19 4 4 12 36 18 18 18 18 42 27 27 27 27 27 27 27 6 30 30 30 30 30 30 30 30 30 30 30 30 30 30 30 30 30 20 18 18 18 25 18 25 18 35 13 30 30 30 30 30 30 30 30 30 30 30 30 30 30 30 30 30 
30 20 29 18 18 18 21 22 18 18 18 25 21 22 18 18 18 18 18 18 18 18 18 18 18 18 18 18 18 28 18 18 25 18 18 18 18 18 18 18 18 18 18 18 18 25 18 28 18 18 25 18 18 25 18 18 18 18 19 4 4 4 20 18 18 18 18 18 18 18 18 18 18 18 18 42 27 27 27 27 27 6 30 30 30 30 30 30 30 30 5 27 27 43 18 18 18 18 18 18 35 13 30 30 30 30 30 5 27 27 27 6 30 30 30 30 30 30 30 30 
30 20 18 14 15 18 18 18 18 14 15 18 18 18 18 14 15 18 18 25 18 18 18 18 18 18 18 18 18 18 18 18 25 18 18 18 18 18 18 29 18 18 18 18 18 18 18 18 18 18 25 18 18 18 18 18 18 18 42 6 1 2 20 18 18 18 18 18 18 18 18 18 18 18 25 18 18 18 18 18 18 42 27 27 6 30 30 30 30 30 20 18 18 28 18 18 18 18 18 35 13 30 30 30 30 30 5 43 18 18 18 42 27 6 30 30 30 30 30 30 
30 20 18 21 22 18 14 15 18 21 22 18 14 15 18 21 22 18 18 18 35 26 26 26 26 26 26 36 18 18 18 18 18 18 18 18 18 18 18 18 18 18 18 18 18 18 18 18 18 18 18 18 25 18 18 18 18 18 18 19 1 2 20 25 25 25 25 25 25 25 25 25 18 18 18 18 18 18 18 18 18 18 18 18 19 30 30 30 30 30 20 18 18 18 18 18 18 18 18 19 30 30 30 30 30 30 20 18 18 18 18 18 18 19 30 30 30 30 30 30 
30 20 18 18 18 25 21 22 18 25 18 25 21 22 18 18 18 35 26 26 13 11 11 11 11 11 11 12 26 36 18 18 18 25 25 18 14 15 18 18 18 18 18 18 35 26 26 26 26 36 18 18 18 18 18 18 18 18 18 19 1 2 20 18 18 18 18 18 18 18 28 18 18 18 18 18 18 25 18 18 18 18 18 18 19 30 30 30 30 5 43 18 18 18 18 25 18 18 18 19 30 30 30 30 30 5 43 18 25 18 18 18 18 42 6 30 30 30 30 30 
30 20 29 14 15 18 18 18 18 14 15 18 18 18 18 29 18 19 11 11 11 11 11 11 11 11 11 11 11 12 26 36 18 18 18 18 21 22 18 18 18 35 26 26 13 11 11 11 11 12 26 26 36 18 18 18 18 14 15 19 1 2 12 26 26 26 26 36 18 18 18 18 18 18 18 18 18 18 18 18 18 18 18 18 42 27 27 27 27 43 18 18 18 18 18 25 18 18 35 13 30 30 30 30 30 20 18 18 18 28 18 18 18 18 19 30 30 30 30 30 
30 20 18 21 22 18 14 15 18 21 22 18 14 15 18 18 35 13 11 11 11 11 11 11 11 11 11 11 11 11 11 12 26 36 18 18 18 18 18 35 26 13 11 11 11 11 11 11 11 11 11 11 20 18 18 18 18 21 22 19 1 2 0 3 3 0 4 20 18 18 18 18 18 18 18 18 18 18 18 18 25 25 25 18 18 18 18 18 18 18 18 25 18 18 25 18 28 18 19 30 30 30 30 30 5 43 18 18 18 18 18 18 18 35 13 30 30 30 30 30 
30 20 18 18 18 25 21 22 18 18 18 18 21 22 35 26 13 11 11 11 11 11 11 11 11 11 11 11 11 11 11 11 11 20 18 18 18 35 26 13 11 11 11 11 11 11 11 11 11 11 11 11 12 26 26 36 18 18 18 19 4 4 7 3 3 7 4 20 25 18 18 18 18 25 18 18 18 18 18 18 18 18 18 18 18 18 25 25 18 18 18 18 25 18 18 18 18 18 19 30 30 30 30 5 43 18 25 25 18 18 18 18 35 13 30 30 30 30 30 30 
30 20 18 14 15 18 18 18 18 14 15 18 18 18 19 11 11 11 11 11 11 11 11 11 11 11 11 11 11 11 11 11 11 12 36 18 35 13 11 11 11 11 11 11 11 11 11 11 11 11 11 11 11 11 11 20 18 18 18 42 27 27 27 27 6 1 2 20 18 18 18 18 18 18 18 18 18 18 18 18 18 18 35 26 26 26 26 26 36 18 18 18 18 18 18 18 18 18 42 27 27 27 27 43 18 25 25 18 18 18 18 35 13 30 30 30 30 30 30 30 
30 20 25 21 22 18 14 15 18 21 22 18 14 15 19 11 11 11 11 11 11 11 11 11 11 11 11 11 11 11 11 11 11 11 20 35 13 11 11 11 11 11 11 11 11 11 11 11 11 11 11 11 11 11 11 20 18 18 18 18 25 18 18 18 19 1 2 12 26 26 26 26 26 36 18 25 18 18 18 18 18 18 19 30 30 30 30 30 12 36 18 18 18 18 18 18 18 25 18 18 18 18 18 18 25 25 18 18 18 18 35 13 30 30 30 30 5 27 6 30 
30 20 18 18 18 18 21 22 18 18 18 18 21 22 19 11 11 11 11 11 11 11 11 11 11 11 11 11 11 11 11 11 11 11 12 13 11 11 11 11 11 11 11 11 11 11 11 11 11 11 11 11 11 11 11 20 18 18 18 25 18 18 18 28 19 1 2 0 0 0 0 0 4 20 18 28 25 25 18 18 18 18 19 30 30 30 30 30 30 12 26 36 18 18 18 18 18 18 18 18 18 18 18 25 18 28 18 18 18 35 13 30 30 30 30 30 20 18 19 30 
30 20 18 14 15 18 18 18 18 14 15 18 18 18 19 11 11 11 11 11 11 11 11 11 11 11 11 11 11 11 11 11 11 11 11 11 11 11 11 11 11 11 11 11 11 11 11 11 11 11 11 11 11 11 11 20 18 18 18 25 18 18 18 18 19 4 4 7 7 7 7 7 4 20 18 18 18 25 25 25 18 18 42 6 30 30 30 30 30 30 30 20 18 18 28 18 18 18 18 18 18 18 25 18 18 18 18 18 35 13 30 30 30 30 5 27 43 18 19 30 
30 20 18 21 22 18 14 15 18 21 22 18 14 15 42 6 11 11 11 11 11 11 11 11 11 11 11 11 11 11 11 11 11 11 11 11 11 11 11 11 11 11 11 11 11 11 11 11 11 11 11 11 11 11 5 43 18 18 25 18 18 18 18 18 42 27 27 27 27 27 6 1 2 20 18 18 18 18 18 25 28 18 18 42 6 30 30 30 30 30 30 20 18 18 18 18 18 18 18 18 18 18 25 18 18 18 35 26 13 30 30 30 30 30 20 18 18 28 19 30 
30 20 29 18 18 18 21 22 18 18 18 18 21 22 18 42 6 11 11 11 11 11 11 11 11 11 11 11 11 11 11 11 11 11 11 11 11 11 11 11 11 11 11 11 11 11 11 11 11 11 11 11 11 11 20 18 18 25 18 18 18 18 18 18 18 18 18 18 18 18 19 1 2 20 18 18 18 18 18 18 25 18 18 18 42 6 30 30 30 30 30 12 26 26 26 26 26 26 26 36 18 18 18 18 18 18 19 30 30 30 30 30 5 27 43 18 18 18 19 30 
30 20 18 14 15 18 18 18 25 14 15 18 18 18 18 18 42 6 11 11 11 11 11 11 11 11 11 11 11 11 11 11 11 11 11 11 11 11 11 11 11 11 11 11 11 11 11 11 11 11 11 11 11 11 20 18 18 25 18 18 18 18 18 18 18 18 29 18 18 18 19 1 2 20 18 18 18 18 18 18 18 18 25 18 18 42 6 30 30 30 30 30 30 30 30 30 30 30 30 12 36 18 18 18 18 35 13 30 30 30 30 30 20 18 18 25 18 18 19 30 
30 20 18 21 22 18 14 15 18 21 22 18 14 15 18 14 15 42 27 6 11 11 11 11 11 11 11 11 11 11 11 11 11 11 11 11 11 11 11 11 11 11 11 11 11 11 11 11 11 11 11 11 11 5 18 18 18 18 18 18 28 18 18 35 26 26 26 26 26 26 13 4 4 12 26 26 26 26 26 26 26 36 25 25 18 18 42 6 30 30 30 30 30 30 30 30 30 30 30 30 12 36 18 18 18 19 30 30 30 30 30 5 43 18 18 25 25 18 19 30 
30 20 18 18 18 18 21 22 18 18 18 18 21 22 18 21 22 18 18 42 6 11 11 11 11 11 11 11 11 11 11 11 11 11 11 11 11 11 11 11 11 11 11 11 11 11 11 11 11 11 11 5 27 43 18 18 25 18 18 18 18 18 18 19 4 4 0 0 0 0 0 4 4 0 0 0 0 0 0 0 0 20 18 25 18 25 18 42 6 30 30 30 30 30 30 30 30 30 30 30 30 12 26 36 18 42 27 6 30 30 5 43 18 18 18 18 18 18 19 30 
30 12 36 18 29 29 18 18 18 14 15 18 18 18 18 18 18 18 18 18 18 6 11 11 11 11 11 11 11 11 11 11 11 11 11 11 11 11 11 11 11 11 11 11 11 11 11 11 11 11 11 20 18 18 18 18 25 18 18 18 18 29 18 19 1 2 7 7 7 7 7 4 4 7 7 7 7 7 7 4 4 20 18 14 15 18 18 18 19 30 30 30 30 30 30 30 30 30 30 30 30 30 30 20 18 18 18 42 27 27 43 18 18 18 18 28 18 18 19 30 
30 30 12 36 18 18 18 18 18 21 22 18 18 29 18 18 18 18 25 18 18 42 27 27 6 11 11 11 11 11 11 11 11 11 11 11 11 11 11 11 11 11 11 11 11 11 11 11 11 5 27 43 18 18 18 18 25 18 18 18 18 18 18 19 1 2 5 27 27 27 27 27 27 27 27 27 27 27 6 1 2 20 18 21 22 18 18 18 42 27 6 30 30 30 30 30 30 30 30 30 30 30 30 12 26 36 18 18 18 18 18 18 18 25 18 18 18 18 19 30 
30 30 30 12 26 26 26 26 26 36 18 18 18 18 18 18 29 18 18 18 18 18 18 18 42 6 11 11 11 11 11 11 11 11 11 11 11 11 11 11 11 11 11 11 11 11 11 11 5 43 18 18 18 18 18 25 29 18 18 29 18 18 18 19 1 2 20 18 18 18 18 18 18 18 18 18 18 18 19 1 2 20 18 18 18 18 18 18 18 18 42 6 30 30 30 30 30 30 30 30 30 30 30 30 30 12 36 18 18 18 18 18 18 18 25 18 18 18 19 30 
30 30 30 30 30 30 30 30 30 12 26 26 26 26 26 36 18 18 18 18 25 18 18 18 18 42 27 27 6 11 11 11 11 11 11 11 11 11 11 11 11 11 11 11 11 11 5 27 43 18 18 18 18 18 18 25 18 35 26 26 26 26 26 13 1 2 20 18 29 18 18 18 18 18 14 15 18 18 19 1 2 12 26 26 26 26 26 26 26 36 18 42 6 30 30 30 30 30 30 30 30 30 30 30 30 30 12 26 36 18 18 18 18 18 18 18 18 18 19 30 
30 30 30 30 30 30 30 30 30 30 30 30 30 30 30 12 26 26 36 18 18 18 18 18 18 18 18 18 42 27 27 6 11 11 11 11 11 11 11 11 11 11 11 11 11 5 43 18 18 18 18 18 18 18 18 18 18 19 4 4 0 0 0 0 0 4 20 18 25 25 18 18 18 18 21 22 18 18 19 1 2 0 0 0 0 0 0 0 0 20 18 18 42 6 30 30 30 30 30 30 30 30 30 30 30 30 30 30 12 26 26 26 36 18 18 18 18 18 19 30 
30 30 30 30 30 30 30 30 30 30 30 30 30 30 30 30 30 30 12 26 36 18 18 18 18 29 18 18 18 18 18 42 27 27 6 11 11 11 11 11 11 11 11 11 11 20 18 18 18 18 29 18 18 18 18 18 18 19 1 2 7 7 7 7 7 4 20 18 18 18 18 29 18 18 18 18 18 18 19 4 4 7 7 7 7 7 7 4 4 20 18 18 18 42 6 30 30 30 30 30 30 30 30 30 30 30 30 30 30 30 30 30 12 26 36 18 18 28 19 30 
30 30 30 30 30 30 30 30 30 30 30 30 30 30 30 30 30 30 30 30 12 26 36 18 18 18 18 18 18 18 18 18 18 18 42 27 6 11 11 11 11 11 11 11 11 20 18 18 18 18 18 18 18 18 18 18 18 19 1 2 5 27 27 27 27 27 43 18 18 18 18 18 25 25 18 18 25 18 42 27 27 27 27 27 27 27 6 1 2 20 18 18 18 18 19 30 30 30 30 30 30 30 30 30 30 30 30 30 30 30 30 30 30 30 12 26 26 36 19 30 
30 30 30 5 27 27 6 30 30 30 30 30 30 30 30 30 30 30 30 30 30 30 20 18 18 18 18 18 28 18 18 18 18 18 18 18 42 6 11 11 11 11 11 11 5 43 18 18 18 18 18 18 18 18 18 18 18 19 1 2 20 18 18 18 18 18 18 18 18 33 34 18 18 25 18 18 18 18 18 18 18 18 18 18 18 18 19 1 2 20 18 25 18 25 42 27 6 30 30 30 30 30 30 30 30 30 30 30 30 30 30 30 30 30 30 30 30 12 13 30 
30 30 5 43 18 25 42 6 30 30 30 30 30 30 30 30 30 30 30 30 30 30 12 26 26 36 18 18 18 18 18 18 18 18 18 18 18 42 27 27 27 27 27 27 43 18 18 18 18 18 18 18 18 18 18 29 18 19 1 2 20 28 18 18 18 18 18 18 18 40 41 18 18 25 18 25 25 18 18 18 18 18 18 18 18 18 19 1 2 20 18 25 25 25 25 18 42 27 27 27 6 30 30 30 30 30 30 30 30 30 30 30 30 30 30 30 30 30 30 30 
30 30 20 28 18 18 18 19 30 30 30 30 30 30 30 30 30 30 30 30 30 30 30 30 30 12 36 18 18 18 18 18 18 18 18 14 15 18 18 18 18 18 18 18 18 18 18 18 18 29 18 18 18 18 18 18 18 19 1 2 20 18 18 18 18 18 31 32 18 18 18 18 18 33 34 18 18 25 18 18 18 14 15 18 18 18 19 1 2 20 18 18 18 18 25 18 18 18 18 18 42 6 30 30 30 30 30 30 30 30 30 30 30 30 30 30 30 30 30 30 
30 30 20 18 18 28 18 19 30 30 30 30 30 30 30 30 30 30 30 30 30 30 30 30 30 30 12 26 36 18 18 18 18 18 18 21 22 18 18 18 18 18 14 15 18 18 18 18 18 18 18 18 18 18 18 18 18 19 1 2 20 18 18 18 18 18 38 39 18 16 17 18 18 40 41 18 18 25 25 18 18 21 22 18 18 18 19 1 2 20 18 28 18 18 25 18 18 18 18 18 18 42 27 27 6 30 30 30 30 30 30 30 30 30 30 30 30 30 30 30 
30 30 12 36 25 18 35 13 30 30 30 30 30 30 30 30 30 30 30 30 30 30 30 30 30 30 30 30 12 26 26 36 18 18 18 18 18 18 18 18 18 18 21 22 18 18 18 18 18 18 18 18 18 18 18 18 35 13 4 4 20 18 18 18 25 18 18 25 25 23 24 18 18 18 18 18 18 18 18 25 18 18 18 18 18 18 19 1 2 20 18 18 18 18 18 18 18 25 25 18 18 18 18 18 42 27 6 30 30 30 30 30 30 30 30 30 30 30 30 30 
30 30 30 12 26 26 13 30 30 30 30 30 30 30 30 30 30 30 30 30 30 30 30 30 30 30 30 30 30 30 30 12 36 18 18 18 18 18 18 18 18 18 18 18 18 18 18 18 18 18 18 35 26 26 36 18 19 4 4 4 20 18 18 18 18 18 18 25 18 18 18 18 18 18 18 25 25 25 25 14 15 25 18 18 18 18 19 1 2 12 26 26 26 26 26 26 36 18 18 18 18 18 25 25 18 18 42 27 6 30 30 30 30 30 30 30 30 30 30 30 
30 30 30 30 30 30 30 30 30 30 30 30 30 30 30 30 30 30 30 30 30 30 30 30 30 30 30 30 30 30 30 30 12 36 18 18 18 18 18 18 18 18 18 18 18 18 18 18 25 18 18 19 11 11 20 18 19 1 2 5 43 18 18 18 29 18 18 25 25 18 18 18 18 18 25 18 18 18 25 21 22 18 18 18 18 18 19 1 2 0 0 0 0 0 0 4 20 18 18 18 18 18 18 25 18 18 18 18 42 27 27 6 30 30 30 30 30 30 30 30 
30 30 30 30 30 30 30 30 30 30 30 30 30 30 30 30 30 30 30 30 30 30 30 30 30 30 30 30 30 30 30 30 30 12 26 36 18 18 18 18 14 15 18 18 18 18 18 18 18 25 18 19 11 11 20 18 19 1 2 20 18 18 18 25 18 18 18 18 25 18 18 18 18 18 28 18 18 18 18 18 18 25 25 18 18 18 19 4 4 7 7 7 7 7 4 4 20 18 25 18 18 18 18 18 18 18 18 18 18 18 18 42 27 6 30 30 30 30 30 30 
30 30 30 30 30 30 30 30 30 30 30 30 30 30 30 30 30 30 30 30 30 30 30 30 30 30 30 30 30 30 30 30 30 30 30 20 18 18 18 18 21 22 18 18 18 18 18 18 18 25 35 13 11 11 20 18 19 8 9 20 18 18 18 25 18 18 18 35 26 26 36 18 18 18 25 25 25 25 25 18 18 18 18 25 18 18 42 27 27 27 27 27 27 6 1 2 20 18 28 18 18 18 18 18 18 18 18 18 29 18 18 18 18 42 27 27 6 30 30 30 
30 30 30 30 30 30 30 30 30 30 30 30 30 30 5 27 6 30 30 30 30 30 30 30 30 30 30 30 30 30 30 30 30 30 30 12 26 26 36 18 18 18 25 25 18 18 18 18 18 18 19 11 11 11 20 18 19 8 9 20 18 28 25 25 18 18 35 13 30 30 12 36 25 25 18 18 18 18 18 18 18 18 18 25 28 25 25 18 18 18 18 18 29 19 1 2 20 18 18 18 18 25 18 18 18 18 18 31 32 18 33 34 18 31 32 18 42 27 6 30 
30 30 30 30 30 30 30 30 30 30 30 30 30 5 43 25 42 6 30 30 30 30 30 30 30 30 30 30 30 30 30 30 30 30 30 30 30 30 12 36 18 18 18 18 18 18 18 18 18 18 19 11 11 5 43 18 19 1 2 20 18 18 18 25 25 35 13 30 30 30 30 12 36 25 18 18 18 18 18 18 18 18 18 18 25 25 25 18 18 18 25 18 18 19 1 2 20 18 18 18 18 18 25 18 18 18 18 38 39 18 40 41 18 38 39 18 18 18 19 30 
30 30 30 30 30 30 30 30 30 30 30 30 30 20 28 18 25 19 30 30 30 30 5 27 27 27 27 27 27 27 27 6 30 30 30 30 30 30 30 20 18 18 18 18 18 25 25 18 18 18 42 27 27 43 18 18 19 1 2 20 18 18 18 18 18 19 30 30 30 30 30 30 20 18 18 25 18 25 25 31 32 18 18 18 18 25 25 18 18 18 14 15 18 19 1 2 20 18 18 18 18 18 18 18 18 18 25 18 18 18 18 25 18 18 18 18 29 18 19 30 
30 5 27 27 27 6 30 30 30 30 30 30 30 12 36 29 35 13 30 30 30 30 20 18 18 18 18 18 18 18 18 42 27 27 27 27 27 27 27 43 18 18 18 18 18 18 25 18 18 18 18 18 18 18 29 18 19 1 2 20 18 18 18 18 18 19 30 30 30 30 30 30 20 18 25 25 18 18 18 38 39 18 18 33 34 18 25 18 18 18 21 22 18 19 1 2 20 18 18 18 18 18 18 18 18 18 18 18 33 34 18 31 32 18 16 17 18 18 19 30 
30 12 36 25 18 42 27 27 6 30 30 30 30 30 12 26 13 30 30 30 5 27 43 18 18 28 18 18 18 18 18 18 18 18 18 18 18 18 18 18 18 18 18 18 18 18 25 25 18 18 25 18 18 18 18 18 19 1 2 20 18 18 18 18 18 18 6 30 30 30 30 5 43 18 18 18 18 18 18 18 18 18 18 40 41 18 18 18 18 18 18 18 18 19 1 2 20 18 18 18 18 18 18 18 18 29 18 18 40 41 18 38 39 18 23 24 18 29 19 30 
30 30 12 36 18 18 28 18 42 6 30 30 30 30 30 30 30 30 30 30 20 18 18 25 18 18 18 18 18 18 25 18 18 18 18 25 18 18 18 18 18 18 18 18 18 18 18 18 18 18 25 18 18 18 18 35 13 4 4 20 18 18 18 29 18 18 42 27 27 27 27 43 25 18 18 16 17 18 29 18 18 18 18 18 18 18 18 18 25 18 14 15 18 19 1 2 20 18 25 18 18 25 25 18 18 18 18 18 18 18 25 18 18 18 18 18 18 18 19 30 
30 30 30 12 26 36 18 18 18 42 27 6 30 30 30 30 30 30 30 30 12 36 18 18 18 35 26 26 26 26 26 26 26 26 26 36 18 18 35 26 26 36 18 18 18 18 18 18 18 18 29 18 18 18 18 19 4 4 4 20 18 18 18 18 18 18 35 26 26 26 36 18 18 25 18 23 24 18 18 18 25 25 18 18 31 32 18 18 18 25 21 22 18 19 1 2 20 18 18 28 18 25 18 18 18 18 18 29 18 31 32 18 33 34 18 16 17 18 19 30 
30 30 30 30 30 12 36 18 25 18 18 42 6 30 30 30 30 30 30 30 30 20 18 18 18 19 30 30 30 30 30 30 30 30 30 12 26 26 13 30 30 12 26 36 18 18 18 18 18 18 25 25 18 18 18 19 1 2 5 43 18 18 18 18 18 18 19 11 11 11 12 26 36 25 18 18 18 18 18 25 16 17 25 18 38 39 18 18 18 25 18 18 18 19 9 9 20 18 18 18 18 18 18 18 18 18 18 18 18 38 39 18 40 41 18 23 24 18 19 30 
30 30 30 30 30 30 12 36 18 18 18 18 42 27 6 30 30 30 30 5 27 43 18 18 35 13 30 30 30 30 30 30 30 30 30 30 30 30 30 30 30 30 30 12 26 36 18 18 18 18 18 25 18 18 18 19 1 2 20 18 18 18 18 18 35 26 13 11 11 11 11 11 20 18 18 18 18 18 18 18 23 24 25 25 18 25 18 18 18 18 14 15 18 19 9 9 20 18 18 18 25 18 18 18 29 18 18 29 18 18 29 18 18 25 18 18 18 18 19 30 
30 30 30 30 30 30 30 12 36 25 18 18 18 18 19 30 30 30 30 20 18 29 18 18 19 30 30 30 30 30 30 30 30 30 30 30 30 30 30 30 30 30 30 30 30 20 18 18 18 18 18 25 18 18 35 13 4 4 20 18 18 18 18 35 13 11 11 11 11 11 11 11 20 18 18 18 18 18 29 18 18 18 18 25 18 18 28 18 18 18 21 22 18 19 1 2 20 18 18 18 18 18 18 18 18 18 18 18 18 18 33 34 18 16 17 18 31 32 19 30 
30 30 30 30 30 30 30 30 20 18 18 18 18 18 19 30 30 30 5 43 18 18 18 18 19 30 30 30 30 30 30 30 5 6 30 30 30 30 30 30 30 30 30 30 30 20 18 18 18 18 18 18 18 18 19 4 4 4 20 18 18 18 18 19 11 11 11 11 11 11 11 11 20 18 18 18 18 18 18 18 18 18 18 18 25 18 25 18 25 18 18 18 18 19 1 2 20 18 18 18 18 18 35 26 26 26 26 26 26 36 40 41 18 23 24 18 38 39 19 30 
30 30 30 30 30 30 30 5 43 18 28 18 35 26 13 30 30 30 20 18 18 25 18 35 13 30 30 30 30 30 30 5 43 19 30 30 30 30 30 30 30 30 30 30 30 20 18 18 25 25 18 18 18 29 19 1 2 5 43 18 29 18 18 19 11 11 11 11 11 11 11 5 43 18 18 29 18 18 18 18 18 18 18 18 18 18 18 25 18 18 14 15 18 19 1 2 20 18 29 18 29 18 19 4 4 4 4 4 4 20 25 18 18 29 18 25 18 18 19 30 
30 30 30 30 30 30 30 20 18 18 18 18 19 30 30 30 30 5 43 18 18 35 26 13 30 30 30 30 30 30 30 20 29 42 27 27 6 30 30 30 30 30 30 30 30 20 18 18 25 18 25 18 18 18 19 1 2 20 18 18 18 18 18 42 27 6 11 11 11 11 11 20 18 18 18 18 18 18 25 25 18 18 28 18 18 25 25 25 18 25 21 22 18 19 1 2 12 26 26 26 26 26 13 4 4 4 4 4 4 12 26 26 26 26 26 26 26 26 13 30 
30 30 30 30 30 30 30 20 18 18 18 18 19 30 30 30 5 43 35 26 26 13 30 30 30 30 30 30 30 30 30 12 36 35 26 26 42 27 27 6 30 30 30 30 5 43 18 25 25 18 25 18 18 18 19 1 2 20 18 18 18 18 18 18 18 19 11 11 5 27 27 43 18 18 18 18 18 18 25 25 25 18 18 18 18 18 18 18 18 18 18 18 18 19 4 0 0 0 0 0 0 0 0 4 4 4 4 4 4 0 0 0 3 3 0 0 0 0 0 30 
30 30 30 30 30 30 5 43 18 18 18 35 13 30 30 30 20 18 19 30 30 30 30 30 30 30 30 30 30 30 30 30 20 19 11 11 12 36 29 19 30 30 30 30 20 18 18 25 18 18 18 18 18 18 19 1 2 20 18 18 18 18 25 18 18 42 27 27 43 18 18 18 18 18 18 18 18 18 18 18 25 18 18 18 18 25 18 18 18 18 14 15 18 19 4 7 7 7 7 7 7 7 7 4 4 4 4 4 4 7 7 7 10 10 7 7 7 7 7 30 
30 30 30 30 5 27 43 18 18 25 18 19 30 30 30 5 43 35 13 30 30 30 30 5 6 30 30 30 30 30 30 30 20 19 11 11 11 12 36 42 6 30 30 5 43 18 14 15 18 18 25 18 18 18 19 1 2 20 18 25 18 18 18 18 18 29 18 18 18 18 18 18 18 18 18 18 18 18 31 32 18 18 18 33 34 25 18 18 18 25 21 22 18 19 1 2 5 27 27 27 27 27 6 4 4 4 4 4 4 5 27 27 27 27 27 27 27 27 6 30 
30 30 30 5 43 18 18 18 18 18 18 19 30 30 5 43 18 19 30 30 30 30 5 43 42 6 30 30 30 30 30 5 43 42 6 11 11 11 20 35 13 30 30 20 18 18 21 22 18 18 25 18 18 18 19 1 2 20 28 18 18 18 29 18 18 18 25 18 18 18 18 29 18 18 18 18 18 18 38 39 18 18 18 40 41 18 18 18 18 18 18 18 18 19 1 2 20 18 29 18 29 18 19 4 4 4 4 4 4 20 18 25 18 25 18 18 18 18 19 30 
30 30 5 43 18 29 18 18 18 18 18 42 27 27 43 18 18 19 30 30 30 30 20 18 18 42 27 27 27 27 27 43 18 18 19 11 11 11 20 19 30 30 30 12 36 18 18 18 18 18 18 29 18 18 19 1 2 20 18 18 18 18 18 18 18 18 18 18 18 18 18 18 18 18 18 18 18 18 18 18 18 18 18 18 18 18 18 18 28 18 18 18 29 19 1 2 20 18 18 18 18 18 42 27 6 1 2 5 27 43 18 16 17 18 18 14 15 18 19 30 
30 30 20 18 18 18 18 18 18 18 25 18 18 18 25 18 18 42 6 30 30 30 20 18 25 18 35 26 26 26 26 26 26 36 42 27 27 27 43 19 30 30 30 30 12 36 18 18 18 18 18 18 18 18 19 1 2 12 26 26 26 26 26 26 26 26 26 26 26 26 26 26 26 26 26 26 26 26 26 26 26 26 26 26 26 26 26 26 26 26 26 26 26 13 1 2 20 18 18 18 25 25 18 29 19 1 2 20 29 18 18 23 24 18 18 21 22 18 19 30 
30 30 12 36 25 18 18 18 18 18 18 18 18 18 18 18 18 18 42 27 27 27 43 18 18 18 19 30 30 30 30 30 30 12 36 35 26 36 29 42 6 30 30 30 30 12 36 18 18 25 18 18 18 18 19 1 2 0 0 0 0 0 0 0 0 0 0 0 0 0 0 3 3 0 0 0 0 0 0 0 0 0 0 0 0 0 0 0 0 0 0 0 0 0 4 4 20 18 18 18 18 18 18 18 19 8 8 20 18 18 18 25 18 25 18 18 14 15 19 30 
30 30 30 20 18 18 35 26 26 26 26 26 26 26 26 26 26 26 26 26 36 18 18 25 18 18 42 6 30 30 30 30 30 30 12 13 30 12 36 35 13 30 30 30 30 30 12 36 18 18 18 18 18 18 19 4 4 7 7 7 7 7 7 7 7 7 7 7 7 7 7 10 10 7 7 7 7 7 7 7 7 7 7 7 7 7 7 7 7 7 7 7 7 7 7 7 20 18 25 18 28 18 18 18 19 8 8 20 18 25 18 18 18 33 34 18 21 22 19 30 
30 30 30 12 36 35 13 30 30 30 30 30 30 30 30 30 30 30 30 30 12 26 36 18 29 18 18 42 6 30 30 30 30 30 30 30 30 30 12 13 30 30 30 30 30 30 30 12 36 18 18 25 29 18 42 27 27 27 27 27 27 27 27 27 27 27 27 27 27 27 27 27 27 27 27 27 27 27 27 27 27 27 27 27 27 27 27 27 27 27 27 27 27 27 27 27 43 18 18 18 18 18 18 18 19 1 2 20 18 18 29 18 25 40 41 18 18 18 19 30 
30 30 30 30 12 13 30 30 30 30 30 30 30 30 30 30 30 30 30 30 30 30 12 26 26 26 26 26 13 30 30 30 30 30 30 30 30 30 30 30 30 30 30 30 30 30 30 30 12 26 26 26 26 26 26 26 26 26 26 26 26 26 26 26 26 26 26 26 26 26 26 26 26 26 26 26 26 26 26 26 26 26 26 26 26 26 26 26 26 26 26 26 26 26 26 26 26 26 26 26 26 26 26 26 13 1 2 12 26 26 26 26 26 26 26 26 26 26 13 30 
30 30 30 30 30 30 30 30 30 30 30 30 30 30 30 30 30 30 30 30 30 30 30 30 30 30 30 30 30 30 30 30 30 30 30 30 30 30 30 30 30 30 30 30 30 30 30 30 30 30 30 30 30 30 30 30 30 30 30 30 30 30 30 30 30 30 30 30 30 30 30 30 30 30 30 30 30 30 30 30 30 30 30 30 30 30 30 30 30 30 30 30 30 30 30 30 30 30 30 30 30 30 30 30 30 30 30 30 30 30 30 30 30 30 30 30 30 30 30 30 

